9.ox
.......oo
.ooooo.o.
....ooo..
o.oo..o.o
o..o...o.
..o...o..
.........
..o...oo.
o..oo....
